1111111111111
100C000000PE1
1111111111111