111111111111111111111111111111
1E0000000000000C00000C00000011
101001010010000010100100000011
101001001010101000100100000011
1P0000000C00C00000000M00000011
1000000000000000M00000M0000011
10000000000000M000000000000011
10000000000000M000000000000011
10000000000000M000000000000011
10000000000000M000000000000011
10000000000000M000000000000011
111111111111111111111111111111
111111111111111111111111111111
111111111111111111111111111111
111111111111111111111111111111