1111111111111
1001CCCC000C1
1000011111001
1P0000E000111
1111111111111