1111111111111
1000000000001
1000000100011
1PE0000C00011
1111111111111
