1111111111111
1000000000001
1000000100011
1ECP000000011
1111111111111
