1111111111111
1000000M00E01
1110000111111
10P0000C00011
1111111111111
