1111111111111
10000000M0001
1110000100011
10PE000C00011
1111111111111
