1111111111111
1M1M000000001
1110000100011
10PM000C00011
1111111111111
