1111111111111
1001CCCC000C1
1000011111001
1PC000E1001C1
1111111111111