1111111111111111111111
1PCCCMCCCCCCCCCMCCCC01
1C11111111001111111CC1
1C10000000000000001CC1
1C10001111111110001CC1
1C10001000M00010001CC1
1C10001011111010001CC1
1C10001010001010001CC1
1CCCCCCCCCMCCCCCCCECC1
1111111111111111111111
