1111111111111111111111
1PCCCCCCCCCCCCCCCCCCE1
1C11111111111111111CC1
1C10000000000000001CC1
1C10001111111110001CC1
1C10001000000010001CC1
1C10001011111010001CC1
1C10001010001010001CC1
1CCCCCCCCCCCCCCCCCCC11
1111111111111111111111
