111111111111111111111
1PCCCCCCCCC00000CCCE1
1C11111111C01110CC111
1C10000000C01110CC111
1C10011110C01110CC111
1C10010010C01110CC111
1C10010010C00000CC111
1CCCCCCCCCCCCCCCCCCC1
111111111111111111111
