1111111111111
1000000000001
1110000100011
10PE000C00011
1111111111111
