111111111111111
1PCCCCCCCCCCCE1
1C11111111111C1
1CC000000000CC1
1C00011111000C1
1C00010001000C1
1C00010M01000C1
1CCCC10001CCCC1
111111111111111
